0222222222220
1000020200010
3032011003212
3010320321012
1120100100310
1012200023010
1022222222230
1300000000130
-- Tunnels: Left=1, Right=11, Y=3
-- Cages: P1=(11,7), P2=(1,7)
