0222222222220
1020000000210
3010231221012
3031000011212
1002300122010
1010000001010
1222222222230
1300000000130
-- Tunnels: Left=1, Right=11, Y=3
-- Cages: P1=(11,7), P2=(1,7)
