0222222222220
1000000000010
3101100110112
3110111101112
1011011011010
1001100110010
1222222222230
1300000000130
-- Tunnels: Left=1, Right=11, Y=3
-- Cages: P1=(11,7), P2=(1,7)
