0222222222220
1010202021010
3103002012112
3200102100032
1011100111010
1110031201110
1223222232230
1300000000130
-- Tunnels: Left=1, Right=11, Y=3
-- Cages: P1=(11,7), P2=(1,7)
