0222222222220
1021002010210
3021120310212
3210002001032
1023102112210
1020002000210
1222322322230
1300000000130
-- Tunnels: Left=1, Right=11, Y=3
-- Cages: P1=(11,7), P2=(1,7)
