0222222222220
1020220220210
3023000012212
3020000000212
1012022203010
1100002000110
1232322323230
1300000000130
-- Tunnels: Left=1, Right=11, Y=3
-- Cages: P1=(11,7), P2=(1,7)
