0222222222220
1000000000010
3111111111112
3201211030032
1012000003010
1101031210110
1232222223230
1300000000130
-- Tunnels: Left=1, Right=11, Y=3
-- Cages: P1=(11,7), P2=(1,7)
